11111111111111111111111
10000000000000000000001
1000110011001111110E001
10001100110011111100001
10001111110000001100001
1000111111000001100P001
10000000110000110100001
100C0000110011111100001
100C0000110011111100001
10000000000000000000001
11111111111111111111111
