111111111111111111111
100000000000000000001
10001100110011111101111
10001100110011111100001
10001111110000011000001
1000111111000011000P001
10000000110001101100001
100C0000110011111100001
10000000000000000000001
11111111111111111111111
